auto-cpufreq	Automatic CPU speed & power optimizer
bat	Cat clone with syntax highlighting
code	Visual Studio Code editor
code-features	Unblock some features in Code OSS
croc	Send things from one computer to another
dino	Modern XMPP (Jabber) chat client
ethtool	Utility for controlling network hardware
fcitx	Context-aware Input Tool
fcitx-configtool	GTK based config tool for Fcitx
fcitx-googlepinyin	Fcitx Wrapper for googlepinyin
flameshot	Simple to use screenshot software
flatpak	Linux application sandboxing
gromit-mpx	On-screen annotation tool
htop	Interactive process viewer
kdeconnect	Communication between KDE and smartphones
keepassxc	Port of Keepass password manager
libinput-gestures	Actions gestures on touchpad
neofetch	System information tool
otf-latin-modern	Computer Modern fonts
otf-latinmodern-math	Computer Modern fonts (math component)
peek	Simple screen recorder
pulseaudio-bluetooth	Bluetooth support for PulseAudio
pulseaudio-zeroconf	Zeroconf support for PulseAudio
python-pip	Tool for installing Python packages
qbittorrent	An advanced BitTorrent client
redshift-qt	Screen temperature changer
rsync	Fast and versatile file copying tool
safeeyes	Reduce and prevent repetitive strain injury
signal-desktop	Signal Private Messenger
syncthing	Continuous replication / synchronization tool
thunderbird	Standalone mail and news reader
tmux	Terminal multiplexer
ttf-font-awesome	Iconic font designed for Bootstrap
ttf-ms-fonts	Microsoft Windows TrueType fonts
ttf-roboto-mono	A monospaced addition to the Roboto type family
unclutter	Hide the mouse cursor
wikiman	Offline search engine for manual pages and documentation
wireguard-tools	Tools for WireGuard configuration
yt-dlp	Download videos from YouTube and a few more sites
